# farm_map.txt — Zone FERME  25 cols × 35 rows  (48 px/tuile → 1200×1680 px)
# 0=herbe  1=herbe_scintille  4=pin  5=buisson  12=terre  13=terre_scintille
# 28=petit_buisson  52=mur_brique  72=plancher_brun(grange)

# ── rangées 0-4 : grange (cols 0-5) ──
 72 72 72 72 72 72  0  0  0  4  0  0  0  0  0  4  0  0  0  0  0  0  0  4  0
 72 72 72 72 72 72  0  0  0  0  0  0  0  0  0  0  0  0  0  0  0  0  0  0  0
 72 72 72 72 72 72  0  0  0  0  0  5  0  0  0  0  0  5  0  0  0  0  0  0  0
 72 72 72 72 72 72  0  0  0  0  0  0  0  0  0  0  0  0  0  0  0  0  0  0  0
 52 52 52 52 52 52  0  0  0  0  0  0  0  0  0  0  0  0  0  0  0  0  0  0  0
# ── rangées 5-7 : zone de transition ──
  0  0  0  0  0  0  0  0  0  0  0  0  0  0  0  0  0  0  0  0  0  0  0  0  0
  0  1  0  0  5  0  0  0  0  0  0  0  0  0  0  0  0  0  0  0  0  0  0  1  0
  0  0  0  0  0  0  0  0  0  0  0  0  0  0  0  0  0  0  0  0  0  5  0  0  0
# ── rangées 8-24 : champ labouré (cols 8-18) ──
  0  0  0  4  0  0  0  0 12 12 12 12 12 12 12 12 12 12 12  0  0  0  0  0  0
  0  0  0  0  0  0  0  0 12 13 12 12 12 12 13 12 12 12 12  0  0  0  0  0  0
  0  0  0  0  0  0  0  0 12 12 12 12 12 12 12 12 12 12 12  0  0  0  0  0  0
  0  1  0  0  0  0  0  0 12 12 13 12 12 13 12 12 12 12 12  0  0  0  0  0  0
  0  0  0  0  0  0  0  0 12 12 12 12 12 12 12 12 12 12 12  0  0  0  0  4  0
  0  0  0  0  0  5  0  0 12 12 12 13 12 12 12 12 12 12 12  0  0  0  0  0  0
  0  0  0  0  0  0  0  0 12 13 12 12 12 12 12 13 12 12 12  0  0  0  0  0  0
  0  0  0  0  0  0  0  0 12 12 12 12 12 12 12 12 12 12 12  0  0  0  0  0  0
  0  4  0  0  0  0  0  0 12 12 12 12 13 12 12 12 12 12 12  0  0  0  0  0  0
  0  0  0  0  0  0  0  0 12 12 13 12 12 12 12 12 13 12 12  0  0  0  0  0  0
  0  0  0  0  0  0  0  0 12 12 12 12 12 12 12 12 12 12 12  0  5  0  0  0  0
  0  0  0  5  0  0  0  0 12 12 12 12 12 13 12 12 12 12 12  0  0  0  0  0  0
  0  0  0  0  0  0  0  0 12 13 12 12 12 12 12 12 12 12 12  0  0  0  0  0  0
  0  0  0  0  0  0  0  0 12 12 12 12 12 12 12 12 12 12 12  0  0  0  0  0  0
  0  1  0  0  0  0  0  0 12 12 12 13 12 12 13 12 12 12 12  0  0  0  0  0  0
  0  0  0  0  0  0  0  0 12 12 12 12 12 12 12 12 12 12 12  0  0  0  4  0  0
  0  0  0  0  0  0  0  0 12 12 12 12 12 12 12 12 12 12 12  0  0  0  0  0  0
# ── rangées 25-34 : zone basse ouverte ──
  0  0  0  0  0  0  0  0  0  0  0  0  0  0  0  0  0  0  0  0  0  0  0  0  0
  0  0  0  0  5  0  0  0  0  0  0  0  0  0  0  0  0  0  0  0  0  0  0  0  0
  0  5  0  0  0  0  0  0  0  0  0  0  0  0  0  0  0  0  0  0  0  0  0  5  0
  0  0  0  0  0  0  0  0  0  0  0  0  0  0  0  0  0  0  0  0  4  0  0  0  0
  0  0  0  1  0  0  0  0  0  0  0  0  0  0  0  0  0  0  0  0  0  0  0  0  0
  0  0  0  0  0  0  0  0  0  0  0  0  0  0  0  0  0  0  0  0  0  0  0  0  0
  0  4  0  0  0  0  0  0  0  0  0  0  0  0  0  0  0  0  0  0  0  0  4  0  0
  0  0  0  0  0  5  0  0  0  0  0  0  0  0  0  0  0  5  0  0  0  0  0  0  0
  0  0  0  0  0  0  0  0  0  0  0  0  0  0  0  0  0  0  0  0  0  0  0  0  0
  0  0  0  0  0  0  0  0  0  0  0  0  0  0  0  0  0  0  0  0  0  0  0  0  0
  4  0  0  0  0  0  0  0  0  0  0  0  0  0  0  0  0  0  0  0  0  0  0  0  4
