# market_map.txt — Zone MARCHÉ  25 cols × 35 rows  (48 px/tuile → 1200×1680 px)
# 96=dalle_grise  97=dalle_alt  120=dalle_claire
# 50=mur_pierre  51=mur_pierre_fenetre
# 83=tonneau  93=lampadaire_point

# rangée 0
 96 96 96 96 96 96 96 96 96 96 96 96 96 96 96 96 96 96 96 96 96 96 96 96 96
# rangée 1 — stand épées (cols 1-4)
 96 50 51 51 50 96 96 96 96 96 96 96 96 50 51 51 50 96 96 96 96 96 96 96 96
# rangée 2
 96 50 51 51 50 96 96 96 96 96 96 96 96 50 51 51 50 96 96 96 96 96 96 96 96
# rangée 3
 96 50 50 50 50 96 96 96 96 96 96 96 96 50 50 50 50 96 96 96 96 96 96 96 96
# rangée 4
 96 96 96 96 96 96 93 96 96 96 96 96 96 96 96 96 96 93 96 96 96 96 96 96 96
# rangée 5
 97 96 96 96 96 96 96 96 96 96 96 96 96 96 96 96 96 96 96 96 96 96 96 96 97
# rangée 6
 96 96 96 96 96 96 96 83 96 96 96 96 96 96 83 96 96 96 96 83 96 96 96 96 96
# rangée 7
 96 96 96 96 96 96 96 96 96 96 96 96 96 96 96 96 96 96 96 96 96 96 96 96 96
# rangée 8 — stand vaches (cols 1-4)
 96 50 51 51 50 96 96 96 96 96 96 96 96 96 96 96 96 96 96 96 96 96 96 96 96
# rangée 9
 96 50 51 51 50 96 96 96 96 96 96 96 96 96 96 96 96 96 96 96 96 96 96 96 96
# rangée 10
 96 50 50 50 50 96 96 96 96 96 96 96 96 96 96 96 96 96 96 96 96 96 96 96 96
# rangée 11
 97 96 96 96 96 96 93 96 96 96 96 96 96 96 96 96 96 96 93 96 96 96 96 96 97
# rangée 12
 96 96 96 96 96 96 96 96 96 96 96 96 96 96 96 96 96 96 96 96 96 96 96 96 96
# rangée 13
 96 96 96 96 96 96 96 83 96 96 96 96 96 96 83 96 96 96 96 96 96 96 96 96 96
# rangée 14 — stand potions (cols 13-16)
 96 96 96 96 96 96 96 96 96 96 96 96 96 50 51 51 50 96 96 96 96 96 96 96 96
# rangée 15
 96 96 96 96 96 96 96 96 96 96 96 96 96 50 51 51 50 96 96 96 96 96 96 96 96
# rangée 16
 96 96 96 96 96 96 96 96 96 96 96 96 96 50 50 50 50 96 96 96 96 96 96 96 96
# rangée 17
 97 96 96 96 96 96 93 96 96 96 96 96 96 96 96 96 96 93 96 96 96 96 96 96 97
# rangée 18
 96 96 96 96 96 96 96 96 96 96 96 96 96 96 96 96 96 96 96 96 96 96 96 96 96
# rangée 19
 96 96 96 96 96 96 96 83 96 96 96 96 96 96 83 96 96 96 96 83 96 96 96 96 96
# rangée 20 — stand bombes (cols 1-4)
 96 50 51 51 50 96 96 96 96 96 96 96 96 96 96 96 96 96 96 96 96 96 96 96 96
# rangée 21
 96 50 51 51 50 96 96 96 96 96 96 96 96 96 96 96 96 96 96 96 96 96 96 96 96
# rangée 22
 96 50 50 50 50 96 96 96 96 96 96 96 96 96 96 96 96 96 96 96 96 96 96 96 96
# rangée 23
 97 96 96 96 96 96 93 96 96 96 96 96 96 96 96 96 96 93 96 96 96 96 96 96 97
# rangée 24
 96 96 96 96 96 96 96 96 96 96 96 96 96 96 96 96 96 96 96 96 96 96 96 96 96
# rangée 25
 96 96 96 96 96 96 96 83 96 96 96 96 96 96 96 96 96 96 96 96 96 96 96 96 96
# rangées 26-34 : espace ouvert
 96 97 96 96 96 96 96 96 96 96 96 96 96 96 96 96 96 96 96 96 96 96 96 97 96
 96 96 96 96 96 96 96 96 96 96 96 96 96 96 96 96 96 96 96 96 96 96 96 96 96
 96 96 96 96 96 96 96 96 96 96 96 96 96 96 96 96 96 96 96 96 96 96 96 96 96
 96 96 96 96 96 96 96 96 96 96 96 96 96 96 96 96 96 96 96 96 96 96 96 96 96
 97 96 96 96 96 96 96 96 96 96 96 96 96 96 96 96 96 96 96 96 96 96 96 96 97
 96 96 96 96 96 96 96 96 96 96 96 96 96 96 96 96 96 96 96 96 96 96 96 96 96
 96 96 96 96 96 96 96 96 96 96 96 96 96 96 96 96 96 96 96 96 96 96 96 96 96
 96 96 96 96 96 96 96 96 96 96 96 96 96 96 96 96 96 96 96 96 96 96 96 96 96
 96 97 96 96 96 96 96 96 96 96 96 96 96 96 96 96 96 96 96 96 96 96 96 97 96
